"filename", "language", "Dart", "comment", "blank", "total"
"c:\Users\mobin\AndroidStudioProjects\flutter_movie\lib\DI\get_it.dart", "Dart", 83, 0, 17, 100
"c:\Users\mobin\AndroidStudioProjects\flutter_movie\lib\Features\Authenticaion\Login\view\login_screen.dart", "Dart", 165, 0, 12, 177
"c:\Users\mobin\AndroidStudioProjects\flutter_movie\lib\Features\Authenticaion\Register\view\register_screen.dart", "Dart", 374, 1, 26, 401
"c:\Users\mobin\AndroidStudioProjects\flutter_movie\lib\Features\Authenticaion\bloc\auth_bloc.dart", "Dart", 33, 0, 8, 41
"c:\Users\mobin\AndroidStudioProjects\flutter_movie\lib\Features\Authenticaion\bloc\auth_event.dart", "Dart", 15, 0, 6, 21
"c:\Users\mobin\AndroidStudioProjects\flutter_movie\lib\Features\Authenticaion\bloc\auth_state.dart", "Dart", 12, 0, 7, 19
"c:\Users\mobin\AndroidStudioProjects\flutter_movie\lib\Features\Authenticaion\data\datasource\authentication_datasource.dart", "Dart", 57, 0, 6, 63
"c:\Users\mobin\AndroidStudioProjects\flutter_movie\lib\Features\Authenticaion\data\model\user.dart", "Dart", 16, 0, 3, 19
"c:\Users\mobin\AndroidStudioProjects\flutter_movie\lib\Features\Authenticaion\data\repository\auth_repository.dart", "Dart", 34, 0, 7, 41
"c:\Users\mobin\AndroidStudioProjects\flutter_movie\lib\Features\Download\view\download_screen.dart", "Dart", 75, 0, 3, 78
"c:\Users\mobin\AndroidStudioProjects\flutter_movie\lib\Features\Home\bloc\home_bloc.dart", "Dart", 63, 1, 6, 70
"c:\Users\mobin\AndroidStudioProjects\flutter_movie\lib\Features\Home\bloc\home_event.dart", "Dart", 6, 0, 4, 10
"c:\Users\mobin\AndroidStudioProjects\flutter_movie\lib\Features\Home\bloc\home_state.dart", "Dart", 26, 0, 5, 31
"c:\Users\mobin\AndroidStudioProjects\flutter_movie\lib\Features\Home\data\datasource\local\advertisment_local_datasource.dart", "Dart", 56, 0, 6, 62
"c:\Users\mobin\AndroidStudioProjects\flutter_movie\lib\Features\Home\data\datasource\local\movei_banner_local_datasource.dart", "Dart", 57, 0, 6, 63
"c:\Users\mobin\AndroidStudioProjects\flutter_movie\lib\Features\Home\data\datasource\local\movei_local_datasource.dart", "Dart", 268, 6, 25, 299
"c:\Users\mobin\AndroidStudioProjects\flutter_movie\lib\Features\Home\data\datasource\remot\advertisment_datasource.dart", "Dart", 23, 0, 4, 27
"c:\Users\mobin\AndroidStudioProjects\flutter_movie\lib\Features\Home\data\datasource\remot\movie_banner_datasource.dart", "Dart", 28, 0, 3, 31
"c:\Users\mobin\AndroidStudioProjects\flutter_movie\lib\Features\Home\data\datasource\remot\movie_datasource.dart", "Dart", 123, 0, 14, 137
"c:\Users\mobin\AndroidStudioProjects\flutter_movie\lib\Features\Home\data\model\advertisment.dart", "Dart", 19, 0, 5, 24
"c:\Users\mobin\AndroidStudioProjects\flutter_movie\lib\Features\Home\data\model\advertisment.g.dart", "Dart", 36, 4, 8, 48
"c:\Users\mobin\AndroidStudioProjects\flutter_movie\lib\Features\Home\data\model\movie.dart", "Dart", 43, 0, 5, 48
"c:\Users\mobin\AndroidStudioProjects\flutter_movie\lib\Features\Home\data\model\movie.g.dart", "Dart", 48, 4, 8, 60
"c:\Users\mobin\AndroidStudioProjects\flutter_movie\lib\Features\Home\data\repository\advertisment_repository.dart", "Dart", 30, 0, 5, 35
"c:\Users\mobin\AndroidStudioProjects\flutter_movie\lib\Features\Home\data\repository\movie_banner_respository.dart", "Dart", 30, 0, 5, 35
"c:\Users\mobin\AndroidStudioProjects\flutter_movie\lib\Features\Home\data\repository\movie_repository.dart", "Dart", 126, 12, 22, 160
"c:\Users\mobin\AndroidStudioProjects\flutter_movie\lib\Features\Home\view\home_screen.dart", "Dart", 628, 1, 27, 656
"c:\Users\mobin\AndroidStudioProjects\flutter_movie\lib\Features\MovieDetial\bloc\movie_detail_bloc.dart", "Dart", 14, 0, 3, 17
"c:\Users\mobin\AndroidStudioProjects\flutter_movie\lib\Features\MovieDetial\bloc\movie_detail_event.dart", "Dart", 2, 0, 2, 4
"c:\Users\mobin\AndroidStudioProjects\flutter_movie\lib\Features\MovieDetial\bloc\movie_detail_state.dart", "Dart", 8, 0, 5, 13
"c:\Users\mobin\AndroidStudioProjects\flutter_movie\lib\Features\MovieDetial\data\datasource\movie_detail_datasource.dart", "Dart", 27, 0, 4, 31
"c:\Users\mobin\AndroidStudioProjects\flutter_movie\lib\Features\MovieDetial\data\model\movie_detile.dart", "Dart", 25, 0, 3, 28
"c:\Users\mobin\AndroidStudioProjects\flutter_movie\lib\Features\MovieDetial\data\repository\movie_detail_repository.dart", "Dart", 20, 0, 4, 24
"c:\Users\mobin\AndroidStudioProjects\flutter_movie\lib\Features\MovieDetial\view\movie_detail_screen.dart", "Dart", 475, 1, 25, 501
"c:\Users\mobin\AndroidStudioProjects\flutter_movie\lib\Features\MovieList\bloc\get_item_card_from_category_home.dart", "Dart", 102, 0, 17, 119
"c:\Users\mobin\AndroidStudioProjects\flutter_movie\lib\Features\MovieList\bloc\movie_list_bloc.dart", "Dart", 22, 0, 3, 25
"c:\Users\mobin\AndroidStudioProjects\flutter_movie\lib\Features\MovieList\bloc\movie_list_event.dart", "Dart", 11, 0, 7, 18
"c:\Users\mobin\AndroidStudioProjects\flutter_movie\lib\Features\MovieList\bloc\movie_list_state.dart", "Dart", 8, 0, 5, 13
"c:\Users\mobin\AndroidStudioProjects\flutter_movie\lib\Features\MovieList\data\datasource\movie_list_datasource.dart", "Dart", 120, 0, 15, 135
"c:\Users\mobin\AndroidStudioProjects\flutter_movie\lib\Features\MovieList\data\model\item_card_movie.dart", "Dart", 7, 0, 2, 9
"c:\Users\mobin\AndroidStudioProjects\flutter_movie\lib\Features\MovieList\data\repository\movie_list_repository.dart", "Dart", 96, 1, 16, 113
"c:\Users\mobin\AndroidStudioProjects\flutter_movie\lib\Features\MovieList\view\movie_list_screen.dart", "Dart", 217, 0, 10, 227
"c:\Users\mobin\AndroidStudioProjects\flutter_movie\lib\Features\TestSc\test_screen.dart", "Dart", 69, 5, 5, 79
"c:\Users\mobin\AndroidStudioProjects\flutter_movie\lib\Features\Welcom\view\welcome_screen.dart", "Dart", 58, 0, 3, 61
"c:\Users\mobin\AndroidStudioProjects\flutter_movie\lib\Features\category\bloc\category_bloc.dart", "Dart", 21, 0, 6, 27
"c:\Users\mobin\AndroidStudioProjects\flutter_movie\lib\Features\category\bloc\category_event.dart", "Dart", 2, 0, 2, 4
"c:\Users\mobin\AndroidStudioProjects\flutter_movie\lib\Features\category\bloc\category_state.dart", "Dart", 11, 0, 5, 16
"c:\Users\mobin\AndroidStudioProjects\flutter_movie\lib\Features\category\data\datasource\category_datasource.dart", "Dart", 69, 0, 5, 74
"c:\Users\mobin\AndroidStudioProjects\flutter_movie\lib\Features\category\data\model\category.dart", "Dart", 22, 0, 5, 27
"c:\Users\mobin\AndroidStudioProjects\flutter_movie\lib\Features\category\data\repository\category_repository.dart", "Dart", 40, 0, 5, 45
"c:\Users\mobin\AndroidStudioProjects\flutter_movie\lib\Features\category\view\category_screen.dart", "Dart", 252, 3, 14, 269
"c:\Users\mobin\AndroidStudioProjects\flutter_movie\lib\constants\custom_colors.dart", "Dart", 10, 0, 2, 12
"c:\Users\mobin\AndroidStudioProjects\flutter_movie\lib\constants\string_constants.dart", "Dart", 13, 0, 3, 16
"c:\Users\mobin\AndroidStudioProjects\flutter_movie\lib\gen\assets.gen.dart", "Dart", 149, 34, 39, 222
"c:\Users\mobin\AndroidStudioProjects\flutter_movie\lib\gen\fonts.gen.dart", "Dart", 5, 9, 5, 19
"c:\Users\mobin\AndroidStudioProjects\flutter_movie\lib\main.dart", "Dart", 113, 0, 5, 118
"c:\Users\mobin\AndroidStudioProjects\flutter_movie\lib\util\enum\category_enum.dart", "Dart", 19, 0, 2, 21
"c:\Users\mobin\AndroidStudioProjects\flutter_movie\lib\util\extetion_function\category_type_enum_extention.dart", "Dart", 26, 0, 10, 36
"c:\Users\mobin\AndroidStudioProjects\flutter_movie\lib\util\extetion_function\context_extention.dart", "Dart", 6, 0, 2, 8
"c:\Users\mobin\AndroidStudioProjects\flutter_movie\lib\util\extetion_function\dio_exception.dart", "Dart", 9, 0, 3, 12
"c:\Users\mobin\AndroidStudioProjects\flutter_movie\lib\util\extetion_function\movie_extention.dart", "Dart", 14, 0, 3, 17
"c:\Users\mobin\AndroidStudioProjects\flutter_movie\lib\util\extetion_function\string_extention.dart", "Dart", 5, 0, 1, 6
"c:\Users\mobin\AndroidStudioProjects\flutter_movie\lib\util\network_util\api_exception.dart", "Dart", 45, 0, 2, 47
"c:\Users\mobin\AndroidStudioProjects\flutter_movie\lib\util\network_util\auth_manager.dart", "Dart", 25, 0, 8, 33
"c:\Users\mobin\AndroidStudioProjects\flutter_movie\lib\util\network_util\dio_provider.dart", "Dart", 7, 0, 2, 9
"c:\Users\mobin\AndroidStudioProjects\flutter_movie\lib\util\network_util\intentnet_checker.dart", "Dart", 12, 0, 3, 15
"c:\Users\mobin\AndroidStudioProjects\flutter_movie\lib\widget\advertisment_banner.dart", "Dart", 58, 0, 4, 62
"c:\Users\mobin\AndroidStudioProjects\flutter_movie\lib\widget\banner.dart", "Dart", 50, 0, 4, 54
"c:\Users\mobin\AndroidStudioProjects\flutter_movie\lib\widget\button_main.dart", "Dart", 35, 0, 4, 39
"c:\Users\mobin\AndroidStudioProjects\flutter_movie\lib\widget\cached_network_image.dart", "Dart", 23, 0, 4, 27
"c:\Users\mobin\AndroidStudioProjects\flutter_movie\lib\widget\shimmer_loading.dart", "Dart", 404, 0, 27, 431
"c:\Users\mobin\AndroidStudioProjects\flutter_movie\lib\widget\show_eror_widget.dart", "Dart", 17, 1, 4, 22
"c:\Users\mobin\AndroidStudioProjects\flutter_movie\lib\widget\toast.dart", "Dart", 11, 0, 2, 13
"Total", "-", 5228, 83, 563, 5874