"filename", "language", "Dart", "comment", "blank", "total"
"c:\Users\mobin\AndroidStudioProjects\flutter_movie\lib\DI\get_it.dart", "Dart", 68, 0, 14, 82
"c:\Users\mobin\AndroidStudioProjects\flutter_movie\lib\Features\Authenticaion\Login\view\login_screen.dart", "Dart", 135, 0, 10, 145
"c:\Users\mobin\AndroidStudioProjects\flutter_movie\lib\Features\Authenticaion\Register\view\register_screen.dart", "Dart", 211, 35, 16, 262
"c:\Users\mobin\AndroidStudioProjects\flutter_movie\lib\Features\Authenticaion\Verification\view\verification_scree.dart", "Dart", 264, 0, 11, 275
"c:\Users\mobin\AndroidStudioProjects\flutter_movie\lib\Features\Authenticaion\data\model\user.dart", "Dart", 29, 0, 3, 32
"c:\Users\mobin\AndroidStudioProjects\flutter_movie\lib\Features\Download\view\download_screen.dart", "Dart", 75, 0, 3, 78
"c:\Users\mobin\AndroidStudioProjects\flutter_movie\lib\Features\Home\bloc\home_bloc.dart", "Dart", 63, 1, 6, 70
"c:\Users\mobin\AndroidStudioProjects\flutter_movie\lib\Features\Home\bloc\home_event.dart", "Dart", 6, 0, 4, 10
"c:\Users\mobin\AndroidStudioProjects\flutter_movie\lib\Features\Home\bloc\home_state.dart", "Dart", 26, 0, 5, 31
"c:\Users\mobin\AndroidStudioProjects\flutter_movie\lib\Features\Home\data\datasource\local\advertisment_local_datasource.dart", "Dart", 56, 0, 6, 62
"c:\Users\mobin\AndroidStudioProjects\flutter_movie\lib\Features\Home\data\datasource\local\movei_banner_local_datasource.dart", "Dart", 57, 0, 6, 63
"c:\Users\mobin\AndroidStudioProjects\flutter_movie\lib\Features\Home\data\datasource\local\movei_local_datasource.dart", "Dart", 268, 6, 25, 299
"c:\Users\mobin\AndroidStudioProjects\flutter_movie\lib\Features\Home\data\datasource\remot\advertisment_datasource.dart", "Dart", 23, 0, 4, 27
"c:\Users\mobin\AndroidStudioProjects\flutter_movie\lib\Features\Home\data\datasource\remot\movie_banner_datasource.dart", "Dart", 25, 0, 3, 28
"c:\Users\mobin\AndroidStudioProjects\flutter_movie\lib\Features\Home\data\datasource\remot\movie_datasource.dart", "Dart", 117, 0, 14, 131
"c:\Users\mobin\AndroidStudioProjects\flutter_movie\lib\Features\Home\data\model\advertisment.dart", "Dart", 19, 0, 5, 24
"c:\Users\mobin\AndroidStudioProjects\flutter_movie\lib\Features\Home\data\model\advertisment.g.dart", "Dart", 36, 4, 8, 48
"c:\Users\mobin\AndroidStudioProjects\flutter_movie\lib\Features\Home\data\model\movie.dart", "Dart", 43, 0, 5, 48
"c:\Users\mobin\AndroidStudioProjects\flutter_movie\lib\Features\Home\data\model\movie.g.dart", "Dart", 48, 4, 8, 60
"c:\Users\mobin\AndroidStudioProjects\flutter_movie\lib\Features\Home\data\repository\advertisment_repository.dart", "Dart", 30, 0, 5, 35
"c:\Users\mobin\AndroidStudioProjects\flutter_movie\lib\Features\Home\data\repository\movie_banner_respository.dart", "Dart", 30, 0, 5, 35
"c:\Users\mobin\AndroidStudioProjects\flutter_movie\lib\Features\Home\data\repository\movie_repository.dart", "Dart", 126, 12, 22, 160
"c:\Users\mobin\AndroidStudioProjects\flutter_movie\lib\Features\Home\view\home_screen.dart", "Dart", 613, 1, 28, 642
"c:\Users\mobin\AndroidStudioProjects\flutter_movie\lib\Features\MovieDetial\view\movie_detail_screen.dart", "Dart", 411, 1, 18, 430
"c:\Users\mobin\AndroidStudioProjects\flutter_movie\lib\Features\MovieList\bloc\item_card_from_category.dart", "Dart", 55, 0, 10, 65
"c:\Users\mobin\AndroidStudioProjects\flutter_movie\lib\Features\MovieList\bloc\item_card_from_home.dart", "Dart", 0, 0, 1, 1
"c:\Users\mobin\AndroidStudioProjects\flutter_movie\lib\Features\MovieList\bloc\movie_list_bloc.dart", "Dart", -18, -3, 0, -21
"c:\Users\mobin\AndroidStudioProjects\flutter_movie\lib\Features\MovieList\data\model\item_card_movie.dart", "Dart", 0, 0, -1, -1
"c:\Users\mobin\AndroidStudioProjects\flutter_movie\lib\Features\TestSc\test_screen.dart", "Dart", 75, 0, 5, 80
"c:\Users\mobin\AndroidStudioProjects\flutter_movie\lib\Features\Welcom\view\welcome_screen.dart", "Dart", 58, 0, 3, 61
"c:\Users\mobin\AndroidStudioProjects\flutter_movie\lib\Features\category\bloc\category_bloc.dart", "Dart", 21, 0, 6, 27
"c:\Users\mobin\AndroidStudioProjects\flutter_movie\lib\Features\category\bloc\category_event.dart", "Dart", 2, 0, 2, 4
"c:\Users\mobin\AndroidStudioProjects\flutter_movie\lib\Features\category\bloc\category_state.dart", "Dart", 11, 0, 5, 16
"c:\Users\mobin\AndroidStudioProjects\flutter_movie\lib\Features\category\data\datasource\category_datasource.dart", "Dart", 69, 0, 5, 74
"c:\Users\mobin\AndroidStudioProjects\flutter_movie\lib\Features\category\data\model\category.dart", "Dart", 22, 0, 5, 27
"c:\Users\mobin\AndroidStudioProjects\flutter_movie\lib\Features\category\data\repository\category_repository.dart", "Dart", 40, 0, 5, 45
"c:\Users\mobin\AndroidStudioProjects\flutter_movie\lib\Features\category\view\category_screen.dart", "Dart", 252, 3, 14, 269
"c:\Users\mobin\AndroidStudioProjects\flutter_movie\lib\constants\custom_colors.dart", "Dart", 10, 0, 3, 13
"c:\Users\mobin\AndroidStudioProjects\flutter_movie\lib\constants\string_constants.dart", "Dart", 10, 0, 2, 12
"c:\Users\mobin\AndroidStudioProjects\flutter_movie\lib\gen\assets.gen.dart", "Dart", 137, 30, 35, 202
"c:\Users\mobin\AndroidStudioProjects\flutter_movie\lib\gen\fonts.gen.dart", "Dart", 5, 9, 5, 19
"c:\Users\mobin\AndroidStudioProjects\flutter_movie\lib\main.dart", "Dart", 81, 0, 4, 85
"c:\Users\mobin\AndroidStudioProjects\flutter_movie\lib\util\enum\category_enum.dart", "Dart", 11, 0, 1, 12
"c:\Users\mobin\AndroidStudioProjects\flutter_movie\lib\util\extetion_function\category_type_enum_extention.dart", "Dart", 17, 0, 2, 19
"c:\Users\mobin\AndroidStudioProjects\flutter_movie\lib\util\extetion_function\context_extention.dart", "Dart", 6, 0, 2, 8
"c:\Users\mobin\AndroidStudioProjects\flutter_movie\lib\util\extetion_function\dio_exception.dart", "Dart", 9, 0, 3, 12
"c:\Users\mobin\AndroidStudioProjects\flutter_movie\lib\util\extetion_function\movie_extention.dart", "Dart", 14, 0, 3, 17
"c:\Users\mobin\AndroidStudioProjects\flutter_movie\lib\util\network_util\api_exception.dart", "Dart", 5, 0, 1, 6
"c:\Users\mobin\AndroidStudioProjects\flutter_movie\lib\util\network_util\dio_provider.dart", "Dart", 7, 0, 2, 9
"c:\Users\mobin\AndroidStudioProjects\flutter_movie\lib\util\network_util\intentnet_checker.dart", "Dart", 12, 0, 3, 15
"c:\Users\mobin\AndroidStudioProjects\flutter_movie\lib\widget\advertisment_banner.dart", "Dart", 58, 0, 4, 62
"c:\Users\mobin\AndroidStudioProjects\flutter_movie\lib\widget\banner.dart", "Dart", 50, 0, 4, 54
"c:\Users\mobin\AndroidStudioProjects\flutter_movie\lib\widget\button_main.dart", "Dart", 35, 0, 4, 39
"c:\Users\mobin\AndroidStudioProjects\flutter_movie\lib\widget\cached_network_image.dart", "Dart", 23, 0, 4, 27
"c:\Users\mobin\AndroidStudioProjects\flutter_movie\lib\widget\shimmer_loading.dart", "Dart", 404, 0, 27, 431
"c:\Users\mobin\AndroidStudioProjects\flutter_movie\lib\widget\show_eror_widget.dart", "Dart", 17, 1, 4, 22
"Total", "-", 4277, 104, 407, 4788